a’a	A’a	A’A
ääliö	Ääliö	ÄÄLIÖ
aandraaien	Aandraaien	AANDRAAIEN
abażur	Abażur	ABAŻUR
abbast	Abbast	ABBAST
accent	Accent	ACCENT
accesit	Accesit	ACCESIT
accommodate	Accommodate	ACCOMMODATE
acqua	Acqua	ACQUA
addio	Addio	ADDIO
æðislegur	Æðislegur	ÆÐISLEGUR
afbryde	Afbryde	AFBRYDE
afdelingschef	Afdelingschef	AFDELINGSCHEF
affisch	Affisch	AFFISCH
äffisch	Äffisch	ÄFFISCH
afflato	Afflato	AFFLATO
afgjort	Afgjort	AFGJORT
afsæt	Afsæt	AFSÆT
aggastyán	Aggastyán	AGGASTYÁN
aggregate	Aggregate	AGGREGATE
aioli	Aioli	AIOLI
aiuole	Aiuole	AIUOLE
alaa	Alaa	ALAA
alááll	Alááll	ALÁÁLL
aladåb	Aladåb	ALADÅB
alfalfa	Alfalfa	ALFALFA
alkflasche	Alkflasche	ALKFLASCHE
åndeløs	Åndeløs	ÅNDELØS
angstschweiß	Angstschweiss	ANGSTSCHWEISS
anklagebænk	Anklagebænk	ANKLAGEBÆNK
anløbsbro	Anløbsbro	ANLØBSBRO
antepenúltimo	Antepenúltimo	ANTEPENÚLTIMO
anywhere	Anywhere	ANYWHERE
aranžer	Aranžer	ARANŽER
argüição	Argüição	ARGÜIÇÃO
arrogation	Arrogation	ARROGATION
asinine	Asinine	ASININE
asketræ	Asketræ	ASKETRÆ
assassinate	Assassinate	ASSASSINATE
assesses	Assesses	ASSESSES
asszony	Asszony	ASSZONY
ástfanginn	Ástfanginn	ÁSTFANGINN
asto	Asto	ASTO
atavistic	Atavistic	ATAVISTIC
atlético	Atlético	ATLÉTICO
automatvåben	Automatvåben	AUTOMATVÅBEN
avväga	Avväga	AVVÄGA
bål	Bål	BÅL
balaclava	Balaclava	BALACLAVA
bananarama	Bananarama	BANANARAMA
bankkonto	Bankkonto	BANKKONTO
barentszzee	Barentszzee	BARENTSZZEE
bassstimme	Bassstimme	BASSSTIMME
bastuugn	Bastuugn	BASTUUGN
battuere	Battuere	BATTUERE
bazter	Bazter	BAZTER
bęcwał	Bęcwał	BĘCWAŁ
beijing	Beijing	BEIJING
beinlínis	Beinlínis	BEINLÍNIS
berjamó	Berjamó	BERJAMÓ
betttuch	Betttuch	BETTTUCH
bezład	Bezład	BEZŁAD
birkiilmur	Birkiilmur	BIRKIILMUR
bistå	Bistå	BISTÅ
blomsterfrø	Blomsterfrø	BLOMSTERFRØ
bocsánat	Bocsánat	BOCSÁNAT
bødestraf	Bødestraf	BØDESTRAF
boekblok	Boekblok	BOEKBLOK
bombaš	Bombaš	BOMBAŠß
bookkeeper	Bookkeeper	BOOKKEEPER
boondoggle	Boondoggle	BOONDOGGLE
brjálaður	Brjálaður	BRJÁLAÐUR
brzdąc	Brzdąc	BRZDĄC
buchstabennerds	Buchstabennerds	BUCHSTABENNERDS
buckety	Buckety	BUCKETY
burggraaf	Burggraaf	BURGGRAAF
byggja	Byggja	BYGGJA
cãibra	Cãibra	CÃIBRA
callipygian	Callipygian	CALLIPYGIAN
cążki	Cążki	CĄŻKI
češnjev	Češnjev	ČEŠNJEV
čevapčič	Čevapčič	ČEVAPČIČ
champú	Champú	CHAMPÚ
chichi	Chichi	CHICHI
chłonność	Chłonność	CHŁONNOŚĆ
chorąży	Chorąży	CHORĄŻY
cilj	Cilj	CILJ
ciselør.	Ciselør	CISELØR
cóccix	Cóccix	CÓCCIX
coccyx	Coccyx	COCCYX
commaaccent	Commaaccent	COMMAACCENT
coñac	Coñac	COÑAC
conseqüência	Conseqüência	CONSEQÜÊNCIA
contexto	Contexto	CONTEXTO
continuum	Continuum	CONTINUUM
coterminous	Coterminous	COTERMINOUS
créée	Créée	CRÉÉE
csali	Csali	CSALI
ćwierćinteligent	Ćwierćinteligent	ĆWIERĆINTELIGENT
cycek	Cycek	CYCEK
czułość	Czułość	CZUŁOŚĆ
dhidi	Dhidi	DHIDI
diminishing	Diminishing	DIMINISHING
död	Död	DÖD
drieërlei	Drieërlei	DRIEËRLEI
duunviro	Duunviro	DUUNVIRO
dvored	Dvored	DVORED
dŵr dwfn	Dŵr Dwfn	DŴR DWFN
dzanga	Dzanga	DZANGA
dziób	Dziób	DZIÓB
dzsóker	Dzsóker	DZSÓKER
ebbe	Ebbe	EBBE
eddzél	Eddzél	EDDZÉL
eðlisfræði	Eðlisfræði	EÐLISFRÆÐI
eenvoudig	Eenvoudig	EENVOUDIG
eftergjort	Eftergjort	EFTERGJORT
einkaaðili	Einkaaðili	EINKAAÐILI
eisschnelllauf	Eisschnelllauf	EISSCHNELLLAUF
eléér	Eléér	ELÉÉR
elektronhéj	Elektronhéj	ELEKTRONHÉJ
éljagangur	Éljagangur	ÉLJAGANGUR
ellilífeyrisþegi	Ellilífeyrisþegi	ELLILÍFEYRISÞEGI
emlék	Emlék	EMLÉK
empreendedor	empreendedor	EMPREENDEDOR
ennuyant	Ennuyant	ENNUYANT
erquickend	Erquickend	ERQUICKEND
essstäbchen	Essstäbchen	ESSSTÄBCHEN
expressão	Expressão	EXPRESSÃO
fabulous	Fabulous	FABULOUS
fellkleid	Fellkleid	FELLKLEID
fetttropfen	Fetttropfen	FETTTROPFEN
ffwndwr	Ffwndwr	FFWNDWR
ffwr-bwt	Ffwr-Bwt	FFWR-BWT
filigree	Filigree	FILIGREE
filling	Filling	FILLING
fjernsyn	Fjernsyn	FJERNSYN
flög	Flög	FLÖG
flotylla	Flotylla	FLOTYLLA
fofofo	Fofofo	FOFOFO
forbigået	Forbigået	FORBIGÅET
forrasztóón	Forrasztóón	FORRASZTÓÓN
frača	Frača	FRAČA
framkvæmd	Framkvæmd	FRAMKVÆMD
fröccsöl	Fröccsöl	FRÖCCSÖL
fuddy-duddy	Fuddy-Duddy	FUDDY-DUDDY
fußballländerspiel	Fussballländerspiel	FUSSBALLLÄNDERSPIEL
gaffall	Gaffall	GAFFALL
gallbladder	Gallbladder	GALLBLADDER
gammel	Gammel	GAMMEL
garaža	Garaža	GARAŽA
geostasis	Geostasis	GEOSTASIS
geschirrreiniger	Geschirrreiniger	GESCHIRRREINIGER
gjörningur	Gjörningur	GJÖRNINGUR
goggles	Goggles	GOGGLES
graffiti	Graffiti	GRAFFITI
gravhøj	Gravhøj	GRAVHØJ
größe	Größe	GRÖSSE
halløj	Halløj	HALLØJ
hamjambo	Hamjambo	HAMJAMBO
hannyrðir	Hannyrðir	HANNYRÐIR
hattyúúr	Hattyúúr	HATTYÚÚR
hawaiian	Hawaiian	HAWAIIAN
heavyweight	Heavyweight	HEAVYWEIGHT
hihhulit	Hihhulit	HIHHULIT
hlátrasköll	Hlátrasköll	HLÁTRASKÖLLl
hlýddi	Hlýddi	HLÝDDI
horror-romance	Horror-Romance	HORROR-ROMANCE
hrææta	Hrææta	HRÆÆTA
huh?	Huh?	HUH?
huichelarij	Huichelarij	HUICHELARIJ
hyvyys	Hyvyys	HYVYYS
igiełka	Igiełka	IGIEŁKA
ignoble	Ignoble	IGNOBLE
ijsvrij	IJsvrij	IJSVRIJ
illi	Illi	ILLI
illigitimate	Illigitimate	ILLIGITIMATE
immagine	Immagine.	IMMAGINE
imminent	Imminent	IMMINENT
indywiduum	Indywiduum	INDYWIDUUM
inequivocabilmente	Inequivocabilmente	INEQUIVOCABILMENTE
inesquecível	Inesquecível	INESQUECÍVEL
innilokaður	Innilokaður	INNILOKAÐUR
ínség	Ínség	ÍNSÉG
insjööring	Insjööring	INSJÖÖRING
íntegra	Íntegra	ÍNTEGRA
irracjonalny	Irracjonalny	IRRACJONALNY
jäääär	Jäääär	JÄÄÄÄR
jættestue	Jættestue	JÆTTESTUE
jałowcówka	Jałowcówka	JAŁOWCÓWKA
járás	Járás	JÁRÁS
justaposição	Justaposição	JUSTAPOSIÇÃO
kaffklatsch	Kaffklatsch	KAFFKLATSCH
kämmekkä	Kämmekkä	KÄMMEKKÄ
kamuflaža	Kamuflaža	KAMUFLAŽA
karikatura	Karikatura	KARIKATURA
karramarro	Karramarro	KARRAMARRO
kendő	Kendő	KENDŐ
kereng’ende	Kereng’ende	KERENG’ENDE
keyword	Keyword	KEYWORD
kézzel	Kézzel	KÉZZEL
kifafa	Kifafa	KIFAFA
kijiji	Kijiji	KIJIJI
kjaftstopp	Kjaftstopp	KJAFTSTOPP
kjarnyrtur	Kjarnyrtur	KJARNYRTUR
klapppult	Klapppult	KLAPPPULT
kohlenstofffaser	Kohlenstofffaser	KOHLENSTOFFFASER
kokoelma	Kokoelma	KOKOELMA
kötőtű	Kötőtű	KÖTŐTŰ
kraguljček	Kraguljček	KRAGULJČEK
kreplach	Kreplach	KREPLACH
krvav	Krvav	KRVAV
kussszene	Kussszene	KUSSSZENE
kyrrð	Kyrrð	KYRRÐ
kyvykkyys	Kyvykkyys	KYVYKKYYS
łasuch	Łasuch	ŁASUCH
lava	Lava	LAVA
lekkoatletka	Lekkoatletka	LEKKOATLETKA
lepotilo	Lepotilo	LEPOTILO
liiert	Liiert	LIIERT
łój	Łój	ŁÓJ
look	Look	LOOK
loppu	Loppu	LOPPU
łubudu	Łubudu	ŁUBUDU
lunedì	Lunedì	LUNEDÌ
łupież	Łupież	ŁUPIEŻŽ
łyko	Łyko	ŁYKO
lyxvillor	Lyxvillor	LYXVILLOR
määräilijä	Määräilijä	MÄÄRÄILIJÄ
mågehøg	Mågehøg	MÅGEHØG
magog	Magog	MAGOG
mämmi	Mämmi	MÄMMI
mammologia	Mammologia	MAMMOLOGIA
mánuðum	Mánuðum	MÁNUÐUM
marmalade	Marmalade	MARMALADE
masques	Masques	MASQUES
matatu	Matatu	MATATU
mchanga	Mchanga	MCHANGA
megég	Megég	MEGÉG
metrópoli	Metrópoli	METRÓPOLI
mgonjwa	Mgonjwa	MGONJWA
mhudumiaji	Mhudumiaji	MHUDUMIAJI
milli vanilli	Milli Vanilli	MILLI VANILLI
minimum	Minimum	MINIMUM
mississippi	Mississippi	MISSISSIPPI
mjini	Mjini	MJINI
mladenič	Mladenič	MLADENIČ
modern	Modern	MODERN
monções	Monções	MONÇÕES
morgengrøde	Morgengrøde	MORGENGRØDE
mørkegrå	Mørkegrå	MØRKEGRÅ
mułła	Mułła	MUŁŁA
mung’unye	Mung’unyem	MUNG’UNYEM
mydło	Mydło	MYDŁO
ñandú	Ñandú	ÑANDÚ
narcissistic	Narcissistic	NARCISSISTIC
nedløbsrør	Nedløbsrør	NEDLØBSRØR
neenoten	Neenoten	NEENOTEN
ng’arange	Ng’arange	NG’ARANGE
ngjyrës	Ngjyrës	NGJYRËS
ngoja	Ngoja	NGOJA
niedźwiedź	Niedźwiedź	NIEDŹWIEDŹ
nietzschean	Nietzschean	NIETZSCHEAN
nieuwbouwwijk	Nieuwbouwwijk	NIEUWBOUWWIJK
nihil	Nihil	NIHIL
niilista	Niilista	NIILISTA
ñimiño	Ñimiño	ÑIMIÑO
nojja	nojja
oddfellow	Oddfellow	ODDFELLOW
oddłużenie	Oddłużenie	ODDŁUŻENIE
odpływ	Odpływ	ODPŁYW
ødselhed	Ødselhed	ØDSELHED
ofbeldi	Ofbeldi	OFBELDI
ohio	Ohio	OHIO
oiseau	Oiseau	OISEAU
okólnik	Okólnik	OKÓLNIK
onomatopoeia	Onomatopoeia	ONOMATOPOEIA
oology	Oology	OOLOGY
Ööröm	Öröm	ÖRÖM
opo	Opo	OPO
orðatiltækið	Orðatiltækið	ORÐATILTÆKIÐ
őröl	Őröl	ŐRÖL
orquídea	orquídea	ORQUÍDEA
oshkosh	Oshkosh	OSHKOSH
óskhyggja	Óskhyggja	ÓSKHYGGJA
övé	Övé	ÖVÉ
paragüeño	Paragüeño	PARAGÜEÑO
passstraße	Passstrasse	PASSSTRASSE
påvist	Påvist	PÅVIST
pępek	Pępek	PĘPEK
perfidy	Perfidy	PERFIDY
pięćsettysięcznik	Pięćsettysięcznik	PIĘĆSETTYSIĘCZNIK
pijjekker	Pijjekker	PIJJEKKER
pług	Pług	PŁUG
polič	Polič	POLIČ
polyvinvyl	Polyvinvyl	POLYVINVYL
poolopaita	Poolopaita	POOLOPAITA
portaaviones	Portaaviones	PORTAAVIONES
prakkari	Prakkari	PRAKKARI
priimek	Priimek	PRIIMEK
pygmy	Pygmy	PYGMY
qabalah	Qabalah	QABALAH
qatartar	Qatartar	QATARTAR
rååål	Rååål	RÅÅÅL
rädda	Rädda	RÄDDA
räffla	Räffla	RÄFFLA
rafiki	Rafiki	RAFIKI
rákos	Rákos	RÁKOS
rammelen	Rammelen	RAMMELEN
revolution	Revolution	REVOLUTION
revving	Revving	REVVING
rhythm	Rhythm	RHYTHM
ríkisstjórn	Ríkisstjórn	RÍKISSTJÓRN
robusto	Robusto	ROBUSTO
room	Room	ROOM
røver	Røver	RØVER
różany	Różany	RÓŻANY
rozzłoszczenie	Rozzłoszczenie	ROZZŁOSZCZENIE
rygga	Rygga	RYGGA
sáttatillaga	Sáttatillaga	SÁTTATILLAGA
sauerstoffflasche	Sauerstoffflasche	SAUERSTOFFFLASCHE
savvy	Savvy	SAVVY
schifffahrt	Schifffahrt	SCHIFFFAHRT
schneeeule	Schneeeule	SCHNEEEULE
schritttempo	Schritttempo	SCHRITTTEMPO
ščinkavec	Ščinkavec	ŠČINKAVEC
šebesa	Šebesa	ŠEBESA
sękacz	Sękacz	SĘKACZ
singhiozzi	Singhiozzi	SINGHIOZZI
sjáaldur	Sjáaldur	SJÁALDUR
skeende	Skeende	SKEENDE
skilji	Skilji	SKILJI
skósóli	Skósóli	SKÓSÓLI
słup	Słup	SŁUP
sopravvivere	Sopravvivere	SOPRAVVIVERE
souffrant	Souffrant	SOUFFRANT
srečnež	Srečnež	SREČNEŽ
stoffblume	Stoffblume	STOFFBLUME
suss	Suss	SUSS
süsüütés	Süsüütés	SÜSÜÜTÉS
swimming	Swimming	SWIMMING
syzygy	Syzygy	SYZYGY
szczenię	Szczenię	SZCZENIĘ
szemérem	Szemérem	SZEMÉREM
sztüx	Sztüx	SZTÜX
tagetage	Tagetage	TAGETAGE
teeei	Teeei	TEEEI
teepee	Teepee	TEEPEE
tennessee	Tennessee	TENNESSEE
tetűűzés	Tetűűzés	TETŰŰZÉS
titular	Titular	TITULAR
töllöttää	Töllöttää	TÖLLÖTTÄÄ
tölvuþrjótur	Tölvuþrjótur	TÖLVUÞRJÓTUR
töölö	Töölö	TÖÖLÖ
töööö	Töööö	TÖÖÖÖ
trawl	Trawl	TRAWL
trekking	Trekking	TREKKING
trittbrett	Trittbrett	TRITTBRETT
trójjęzyczność	Trójjęzyczność	TRÓJJĘZYCZNOŚĆ
tryggja	Tryggja	TRYGGJA
tyylilyyli	Tyylilyyli	TYYLILYYLI
tyynynpäällinen	Tyynynpäällinen	TYYNYNPÄÄLLINEN
učenje	Učenje	UČENJE
ujjak	Ujjak	UJJAK
ummetus	Ummetus	UMMETUS
unnecessary	Unnecessary	UNNECESSARY
upplýsingatækni	Upplýsingatækni	UPPLÝSINGATÆKNI
urżnąć	Urżnąć	URŻNĄĆ
útivistarfólk	Útivistarfólk	ÚTIVISTARFÓLK
útlönd	Útlönd	ÚTLÖND
útsæ	Útsæ	ÚTSÆ
uutuus	Uutuus	UUTUUS
vähälaktoosisia	Vähälaktoosisia	VÄHÄLAKTOOSISIA
vámszedőőr	Vámszedőőr	VÁMSZEDŐŐR
verjüngung	Verjüngung	VERJÜNGUNG
víðsjá	Víðsjá	VÍÐSJÁ
vollblut	Vollblut	VOLLBLUT
voorraad	Voorraad	VOORRAAD
waffle	Waffle	WAFFLE
wavy	Wavy	WAVY
wchrzanią	Wchrzanią	WCHRZANIĄ
weöres	Weöres	WEÖRESXx:
wiąz	Wiąz	WIĄZ
wienerbrød	Wienerbrød	WIENERBRØD
wyvern	Wyvern	WYVERN
ýmislegt	Ýmislegt	ÝMISLEGT
yndisfríð	Yndisfríð	YNDISFRÍÐ
yngismey	Yngismey	YNGISMEY
yngre	Yngre	YNGRE
yog-sothoth	Yog-Sothoth	YOG-SOTHOTH
yötyö	Yötyö	YÖTYÖ
yvette	Yvette	YVETTE
zaangażować	Zaangażować	ZAANGAŻOWAĆ
żałość	Żałość	ŻAŁOŚĆ
źdźbło	Źdźbło	ŹDŹBŁO
żółć	Żółć	ŻÓŁĆ
zoophobie	Zoophobie	ZOOPHOBIE
zozoa	Zozoa	ZOZOA
zylinder	Zylinder	ZYLINDER
þangað	Þangað	ÞANGAÐ
þvag	Þvag	ÞVAG
